Second_Level.txt

10;1;1;1;1;3,3,0;0

%;7,10,0
r;8,8,0
d;4,9,0
b;1,1,0

0,,,,,,,,,,,,,,0
0,,,,,,,,,,,,,,0
0,,,,,,,,,,,,,,0
0,,,,,,,,,,,,,,0
0,,,,,,,,,,,,,,0
0,,,,,,,,,,,,,,0
0,,,,,,,,,,,,,,0
0,,,,,,,,,,,,,,0
000000000,,,,,,0
0,,,,,,,0,,,,,,0
0,,,,,,,0,,,,,,0
0,,,,,,,0,,,,,,0
0,,,00000,,,,,,0
0,,,,,,,,,,,,,,0
0,,,,,,,,,,,,,,0
0000000000000000

EMPTY

[;14,7,0;Starting_Level.txt

*;1,1,0;10
*;2,1,0;10
*;3,1,0;10