Second_Level.txt

10;1;1;1;1;3,3,0;0

%;7,10,0
r;8,8,0
d;4,9,0
¨;1,1,0

0,,,,,,,,,,,,,,0
0,,,,,,,,,,,,,,0
0,,,,,,,,,,,,,,0
0,,,,,,,,,,,,,,0
0,,,,,,,,,,,,,,0
0,,,,,,,,,,,,,,0
0,,,,,,,,,,,,,,0
0,,,,,,,,,,,,,,0
000000000,,,,,,0
0,,,,,,,0,,,,,,0
0,,,,,,,0,,,,,,0
0,,,,,,,0,,,,,,0
0,,,00000,,,,,,0
0,,,,,,,,,,,,,,0
0,,,,,,,,,,,,,,0
0000000000000000

EMPTY

[;15,7,0;Starting_Level.txt

EMPTY